### #######
#       O #
#   P #####
#         #
#### ##   #
# O  ##   #
#    ##   #
#         #
#     XX  #
#     #   #
### #######